8,4,4,5,4,4,6,5,4,4,4,5,4,4,4,5,4,4,4,5,4,4,4,9
8,0,1,0,0,0,0,0,0,0,0,0,1,0,0,0,1,0,0,0,1,0,0,8
9,0,0,0,0,1,0,2,0,0,0,0,0,0,0,0,0,0,0,0,0,0,0,9
9,0,0,3,12,0,0,0,0,3,0,0,0,0,0,0,0,0,0,0,0,0,0,8
9,0,0,0,0,0,0,9,8,0,0,2,0,3,0,2,0,3,0,2,0,3,0,8
8,0,0,0,0,1,0,4,5,0,0,0,0,0,0,0,0,0,0,0,0,0,1,8
8,0,2,0,0,0,0,0,0,0,0,0,0,1,0,0,0,1,0,0,0,1,0,9
8,0,2,0,0,0,0,0,0,0,0,0,0,1,0,0,0,1,0,0,0,1,0,9
8,0,2,0,0,0,0,0,0,0,0,0,0,1,0,0,0,1,0,0,0,1,0,9
8,0,1,0,0,0,0,0,0,0,0,0,1,0,0,0,1,0,0,0,1,0,0,8
9,0,0,0,0,1,0,2,0,0,0,0,0,0,0,0,0,0,0,0,0,0,0,9
9,0,0,3,0,0,0,0,0,3,0,0,0,0,0,0,0,0,0,0,0,0,0,8
8,0,2,0,0,0,0,0,0,0,0,0,0,1,0,0,0,1,0,0,0,1,0,9
9,0,0,0,3,0,0,0,0,2,0,0,0,0,0,0,0,0,0,0,0,0,13,9
5,4,5,5,4,4,4,5,6,4,4,7,5,4,4,7,5,4,4,7,5,4,4,4